ANIMAL	DIET
squid	carnivore
spider	carnivore
ants	omnivore
baboons	carnivore
sea lion	carnivore
orangutans	omnivore
pigeons	omnivore
crows	omnivore
sheep	herbivore
raccoons	omnivore
horses	herbivore
rhesus monkeys	omnivore
falcons	carnivore
rats	omnivore
owls	carnivore
cats	carnivore
squirrels	omnivore
elephants	herbivore
octopus	carnivore
dogs	carnivore
whales	carnivore
parrots	omnivore
bottlenose dolphins	carnivores
pigs	omnivores
chimpanzees	omnivores
